ь -> о
о -> э
э -> с
с -> п
п -> д
д -> ш
ш -> л
л -> e
е -> а
а -> ч
ч -> х
x -> ь

ю -> т
т -> з
з -> р
р -> щ
щ -> м
м -> г
г -> ы
ы -> н
н -> я
я -> у
у -> ж
ж -> в
в -> ъ
ъ -> ю

й -> б
б -> к
к -> ц
ц -> й

ф -> и
и -> ф
